{
    "WATER": [
        "S9_T",
        "S119_T",
        "S335_T",
        "S331_H",
        "S151_T",
        "3B-SE_B",
        "S334_T",
        "S123_T",
        "S165_H",
        "T5_H",
        "G211_H",
        "S118_T",
        "G72_T",
        "S125_H",
        "S142_T",
        "G119_T",
        "S167_H",
        "C11UFL_O",
        "S338_H",
        "S179_T",
        "G93_H",
        "S148_T",
        "S336_T",
        "S337_T",
        "S166_H",
        "S34_H",
        "G54_H",
        "S124_H",
        "S143_T",
        "S34_T",
        "S166_T",
        "G54_T",
        "S124_T",
        "S149_H",
        "G93_T",
        "S336_H",
        "S148_H",
        "G86S_H",
        "S142_H",
        "S125_T",
        "G119_H",
        "S167_T",
        "S179_H",
        "S338_T",
        "S123_H",
        "S165_T",
        "G211_T",
        "S118_H",
        "G72_H",
        "G86N_H",
        "S334_H",
        "G58_H",
        "S335_H",
        "S331_T",
        "C11U75_O",
        "S151_H",
        "S119_H",
        "S32_H"
    ],
    "WELL": [
        "HUMBLE",
        "DUCLOS",
        "ANGEL",
        "KROME"
    ],
    "RAIN": [
        "S124_R",
        "S20G_R",
        "HOMES.FS_R",
        "S338_R",
        "S167_R",
        "G54_R",
        "S20F_R",
        "S34_R",
        "S125_R",
        "SBDD",
        "S26_R",
        "S36_R",
        "S165_R",
        "FT. LAUD_R",
        "S27_R",
        "S331_R",
        "GILL REA_R",
        "S28Z_R",
        "S335_R",
        "S21A_R",
        "S33_R",
        "S29_R",
        "S29Z_R",
        "S123",
        "S9_R",
        "S13_R",
        "MIAMI.FS_R",
        "S334_R",
        "S336_R",
        "S30_R",
        "S179_R",
        "S331W",
        "S21_R"
    ],
    "PUMP": [
        "S9_P",
        "S331_P",
        "S13_P",
        "G123_P"
    ],
    "GATE": [
        "S34_C",
        "S124_C",
        "S13A_C",
        "G211_C",
        "S11A_C",
        "G54_S",
        "S32_C",
        "S122_C",
        "G58_C",
        "S151_C",
        "G93",
        "G86N_C",
        "S196_C",
        "S31_C",
        "G119_C",
        "S194_C",
        "S142_C",
        "S118_S",
        "S121_C",
        "S25A_C",
        "S32A_C",
        "S120_C",
        "S119_S",
        "S143_C",
        "S195_C"
    ]
}