{
    "WATER": [
        "S334_H",
        "G86N_H",
        "S118_H",
        "G211_T",
        "S9_H",
        "G93_T",
        "S165_T",
        "S123_H",
        "S119_H",
        "S151_H",
        "S331_T",
        "S335_H",
        "G54_T",
        "S34_T",
        "S149_H",
        "S337_H",
        "S32_H",
        "S124_T",
        "G58_H",
        "S166_T",
        "S179_H",
        "S338_T",
        "S167_T",
        "G119_H",
        "G86S_H",
        "G72_H",
        "S336_H",
        "S148_H",
        "G72_T",
        "S148_T",
        "S336_T",
        "3B-SE_B",
        "S338_H",
        "S179_T",
        "S167_H",
        "G119_T",
        "S143_T",
        "S124_H",
        "S166_H",
        "S337_T",
        "S151_T",
        "S331_H",
        "S335_T",
        "G54_H",
        "S34_H",
        "T5_H",
        "S119_T",
        "S118_T",
        "S9_T",
        "G211_H",
        "G93_H",
        "S165_H",
        "S123_T",
        "S334_T"
    ],
    "WELL": [
        "KROME",
        "ANGEL",
        "HUMBLE"
    ],
    "RAIN": [
        "MIAMI.FS_R",
        "S36_R",
        "S9_R",
        "S331_R",
        "S165_R",
        "S20F_R",
        "G54_R",
        "SBDD",
        "S331W",
        "S336_R",
        "HOMES.FS_R",
        "GILL REA_R",
        "FT. LAUD_R",
        "S13_R"
    ],
    "PUMP": [
        "G123_P",
        "S13_P",
        "S331_P",
        "S9_P"
    ],
    "GATE": [
        "S34_C",
        "S151_C",
        "S24_C",
        "S122_C",
        "S196_C",
        "G86N_C",
        "G93",
        "S173_C",
        "S118_S",
        "S142_C",
        "G86S_C",
        "S194_C",
        "G119_C",
        "S121_C",
        "S120_C",
        "S24A_C",
        "S195_C",
        "S143_C",
        "S119_S",
        "G54_S",
        "S32_C",
        "G58_C",
        "S124_C",
        "S9XN_C",
        "S31_C",
        "G211_C",
        "S13A_C",
        "S11A_C",
        "S30_C"
    ]
}