{
    "WATER": [
        "S9_H",
        "G86N_H",
        "S118_H",
        "S123_H",
        "S165_T",
        "S334_H",
        "S331_T",
        "S151_H",
        "S335_H",
        "S119_H",
        "S124_T",
        "S337_H",
        "S149_H",
        "S148_H",
        "S336_H",
        "S338_T",
        "S179_H",
        "G86S_H",
        "G119_H",
        "S167_H",
        "S179_T",
        "S338_H",
        "G119_T",
        "S336_T",
        "S337_T",
        "S124_H",
        "S166_H",
        "S119_T",
        "S32_H",
        "S331_H",
        "S151_T",
        "S335_T",
        "G58_H",
        "S334_T",
        "S9_T",
        "S118_T",
        "S123_T",
        "S165_H"
    ],
    "WELL": [
        "HUMBLE",
        "KROME",
        "ANGEL"
    ],
    "RAIN": [
        "S20F_R",
        "S36_R",
        "S331_R",
        "S9_R",
        "MIAMI.FS_R",
        "FT. LAUD_R",
        "GILL REA_R",
        "S13_R",
        "HOMES.FS_R",
        "S336_R"
    ],
    "PUMP": [
        "G123_P",
        "S13_P",
        "S9_P",
        "S331_P"
    ],
    "GATE": [
        "S165_S",
        "S9XN_C",
        "S124_C",
        "S166_S",
        "S11A_C",
        "S34_C",
        "S13A_C",
        "S167_S",
        "S196_C",
        "G86N_C",
        "G93",
        "S179_S",
        "S148_S",
        "S28_S",
        "S30_C",
        "S31_C",
        "S151_C",
        "S122_C",
        "S24A_C",
        "S195_C",
        "S143_C",
        "S119_S",
        "S120_C",
        "S32_C",
        "S173_C",
        "G58_C",
        "S118_S",
        "S142_C",
        "S194_C",
        "G119_C"
    ]
}