{
    "WATER": [
        "G119_T",
        "S34_T",
        "S119_H",
        "G119_H",
        "S335_H",
        "S179_H",
        "S123_H",
        "G54_H",
        "S125_T",
        "S336_T",
        "S165_T",
        "S165_H",
        "G211_T",
        "S334_H",
        "S118_T",
        "S167_H",
        "S331_T",
        "S338_T",
        "S148_H",
        "S151_H",
        "G72_H",
        "S125_H",
        "S334_T",
        "C11UFL_O",
        "G86S_H",
        "S335_T",
        "S166_H",
        "G86N_H",
        "S119_T",
        "S9_T",
        "S142_H",
        "S338_H",
        "S123_T",
        "S151_T",
        "G93_H",
        "S148_T",
        "G93_T",
        "3B-SE_B",
        "G211_H",
        "S143_T",
        "S167_T",
        "S124_T",
        "S331_H",
        "S118_H",
        "G54_T",
        "S34_H",
        "S337_T",
        "S32_H",
        "S166_T",
        "C11U75_O",
        "T5_H",
        "S336_H",
        "S124_H",
        "S179_T",
        "G58_H",
        "S142_T",
        "S149_H",
        "G72_T"
    ],
    "WELL": [
        "HUMBLE",
        "KROME",
        "DUCLOS",
        "ANGEL"
    ],
    "RAIN": [
        "S338_R",
        "HOMES.FS_R",
        "S27_R",
        "S125_R",
        "S124_R",
        "S179_R",
        "S29_R",
        "G54_R",
        "S165_R",
        "S26_R",
        "MIAMI.FS_R",
        "S335_R",
        "S331_R",
        "S331W",
        "S167_R",
        "S33_R",
        "S123",
        "S36_R",
        "S34_R",
        "FT. LAUD_R",
        "S30_R",
        "S29Z_R",
        "S28Z_R",
        "S21_R",
        "S20G_R",
        "S13_R",
        "S20F_R",
        "S334_R",
        "GILL REA_R",
        "S336_R",
        "S21A_R",
        "S9_R",
        "SBDD"
    ],
    "PUMP": [
        "G123_P",
        "S331_P",
        "S13_P",
        "S9_P"
    ],
    "GATE": [
        "S32_C",
        "S11A_C",
        "S142_C",
        "G86N_C",
        "S31_C",
        "G93",
        "S151_C",
        "S119_S",
        "G211_C",
        "S13A_C",
        "S143_C",
        "S195_C",
        "G58_C",
        "S124_C",
        "S25A_C",
        "S32A_C",
        "S118_S",
        "S196_C",
        "S34_C",
        "S122_C",
        "G119_C",
        "S194_C",
        "S121_C",
        "S120_C",
        "G54_S"
    ]
}