{
    "WATER": [
        "G119_T",
        "S34_T",
        "S119_H",
        "G119_H",
        "S335_H",
        "S179_H",
        "S123_H",
        "G54_H",
        "S336_T",
        "S165_T",
        "S165_H",
        "G211_T",
        "S334_H",
        "S118_T",
        "S167_H",
        "S331_T",
        "S338_T",
        "S148_H",
        "S151_H",
        "G72_H",
        "S334_T",
        "G86S_H",
        "S9_H",
        "S335_T",
        "S166_H",
        "G86N_H",
        "S119_T",
        "S9_T",
        "S338_H",
        "S123_T",
        "S151_T",
        "G93_H",
        "S148_T",
        "G93_T",
        "3B-SE_B",
        "G211_H",
        "S143_T",
        "S167_T",
        "S124_T",
        "S331_H",
        "S118_H",
        "G54_T",
        "S34_H",
        "S337_H",
        "S337_T",
        "S32_H",
        "S166_T",
        "T5_H",
        "S336_H",
        "S124_H",
        "S179_T",
        "G58_H",
        "S149_H",
        "G72_T"
    ],
    "WELL": [
        "HUMBLE",
        "KROME",
        "ANGEL"
    ],
    "RAIN": [
        "HOMES.FS_R",
        "G54_R",
        "S165_R",
        "MIAMI.FS_R",
        "S331_R",
        "S331W",
        "S36_R",
        "FT. LAUD_R",
        "S13_R",
        "S20F_R",
        "GILL REA_R",
        "S336_R",
        "S9_R",
        "SBDD"
    ],
    "PUMP": [
        "G123_P",
        "S331_P",
        "S13_P",
        "S9_P"
    ],
    "GATE": [
        "S32_C",
        "S11A_C",
        "S142_C",
        "S24_C",
        "G86N_C",
        "S31_C",
        "G93",
        "S151_C",
        "S9XN_C",
        "S119_S",
        "G211_C",
        "S13A_C",
        "S143_C",
        "S195_C",
        "G58_C",
        "S124_C",
        "S173_C",
        "S30_C",
        "S118_S",
        "S196_C",
        "S34_C",
        "S122_C",
        "G86S_C",
        "G119_C",
        "S194_C",
        "S121_C",
        "S120_C",
        "G54_S",
        "S24A_C"
    ]
}