{
    "WATER": [
        "G119_T",
        "S119_H",
        "G119_H",
        "S335_H",
        "S179_H",
        "S123_H",
        "S336_T",
        "S165_T",
        "S165_H",
        "S334_H",
        "S118_T",
        "S167_H",
        "S331_T",
        "S338_T",
        "S148_H",
        "S151_H",
        "S334_T",
        "G86S_H",
        "S9_H",
        "S335_T",
        "S166_H",
        "G86N_H",
        "S119_T",
        "S9_T",
        "S338_H",
        "S123_T",
        "S151_T",
        "S124_T",
        "S331_H",
        "S118_H",
        "S337_H",
        "S337_T",
        "S32_H",
        "S336_H",
        "S124_H",
        "S179_T",
        "G58_H",
        "S149_H"
    ],
    "WELL": [
        "HUMBLE",
        "KROME",
        "ANGEL"
    ],
    "RAIN": [
        "HOMES.FS_R",
        "MIAMI.FS_R",
        "S331_R",
        "S36_R",
        "FT. LAUD_R",
        "S13_R",
        "S20F_R",
        "GILL REA_R",
        "S336_R",
        "S9_R"
    ],
    "PUMP": [
        "G123_P",
        "S331_P",
        "S13_P",
        "S9_P"
    ],
    "GATE": [
        "S32_C",
        "S11A_C",
        "S142_C",
        "S148_S",
        "G86N_C",
        "S31_C",
        "G93",
        "S151_C",
        "S9XN_C",
        "S119_S",
        "S13A_C",
        "S143_C",
        "S195_C",
        "G58_C",
        "S124_C",
        "S173_C",
        "S30_C",
        "S118_S",
        "S28_S",
        "S196_C",
        "S34_C",
        "S122_C",
        "G119_C",
        "S194_C",
        "S165_S",
        "S120_C",
        "S167_S",
        "S166_S",
        "S24A_C",
        "S179_S"
    ]
}