{
    "WATER": [
        "S119_H",
        "S335_H",
        "S179_H",
        "S123_H",
        "S336_T",
        "S165_T",
        "S165_H",
        "S334_H",
        "S118_T",
        "S167_H",
        "S331_T",
        "S338_T",
        "S148_H",
        "S151_H",
        "S334_T",
        "S9_H",
        "S335_T",
        "S166_H",
        "S119_T",
        "S9_T",
        "S338_H",
        "S123_T",
        "S151_T",
        "S13_T",
        "S13_H",
        "S331_H",
        "S118_H",
        "S337_H",
        "S337_T",
        "S336_H",
        "S179_T",
        "S149_H"
    ],
    "WELL": [
        "HUMBLE",
        "ANGEL"
    ],
    "RAIN": [
        "HOMES.FS_R",
        "G54_R",
        "MIAMI.FS_R",
        "S331_R",
        "S36_R",
        "FT. LAUD_R",
        "DIXIE WA_R",
        "S13_R",
        "S20F_R",
        "GILL REA_R",
        "S336_R",
        "S9_R"
    ],
    "PUMP": [
        "S331_P",
        "S13_P",
        "S9_P"
    ],
    "GATE": [
        "S32_C",
        "S148_S",
        "G86N_C",
        "S151_C",
        "S119_S",
        "S195_C",
        "S21A_S",
        "S173_C",
        "S118_S",
        "S28_S",
        "S34_C",
        "G86S_C",
        "S123_S",
        "S194_C",
        "S22_S",
        "S165_S",
        "S167_S",
        "S166_S",
        "S179_S"
    ]
}